1111111111111111111111111111111111
1000000000000000000000000000000001
1001111111000000000000000000000001
1000000001000000001111111100000001
1000000001000000001000000100000001
1000000001000000001000000100000001
1000000001000000001000000100001001
1000000001111111111000000100001001
1000000000000000000000000100001001
1000000000000000000000000100001001
1000000000111111111111111100001001
1000000000100000000000000000001001
1000000000100000000000000000001001
1000000000111111111111111111111001
1000000000000000000000000000000001
1000000000000000000000000000000001
1111111111111111111111111111111111